1111111111111111111
1000000000000000001
1000000000000000101
1000000000000E00001
100000000000C000001
1000000P00C00000001
10000000C0000000001
1000000000000000001
1000000000000000001
1000000000000000001
1111111111111111111
