11111111111111111111
1C00000000P0000000C1
10000000000000000001
10000000000000000001
10000000000000000001
10000000000000000001
1000000000X000000001
1000000000X000000001
1000000000X000000001
1000000000X000000001
10000000000000000001
10000000000000000001
10000000000000000001
10000000000000000001
1C0000000E00000000C1
11111111111111111111