1111111111111111111
1000000000000000001
1000000000000000101
10000000000000000E1
100000000000C0000001
1000000P00C00000001
10000000C0000000001
1000000000000000001
1000000000000000000001
1000000000000001101
1111111111110011111
			11
