11111111111111111111
1P0X00000000000000C1
100X0000000000000001
100X0000000000000001
100X0000000000000001
1XXX0000000000000001
10000000000000000001
10000000000000000001
10000000000000000001
10000000000000000001
10000000000000000001
10000000000000000001
10000000000000000001
10000000000000000001
1C0000000E00000000C1
11111111111111111111
