1111111111111111111
1000000000000000001
1000000000000000101
1000000E00000000001
100000000000C000001
1000000000C00000001
1111100000C00000001
111110000000Z000001
111110000000P000001
111110Z000000000001
1111111111111111111
