11111111111111111111
1C00000000P0000000C1
10000000000000000001
100000000000000N0001
10000000000000000001
100V0000000000000001
10000000000000000001
10000000000000000001
1000000V000000000001
10000000000000000001
10000000000000000001
10000000000000V00001
10000000000000000001
10000000000000000001
1C0000000E00000000C1
11111111111111111111
