11111111111111111111
1P1100000000000000C1
11110000000000000001
10000000000000000001
10000000000000000001
10000000000000000001
10000000000000000001
10000000000000000001
10000000000000000001
10000000000000000001
10000000000000000001
10000000000000000001
10000000000000000001
10000000000000000001
1C0000000E00000000C1
11111111111111111111
