11111111111111111111
1XXXXXXXXXXXXXXXXXX1
1XXXXXXXXXXXXXXXXXX1
1XXXXXXXXXXXXXXXXXX1
1XXXXXXXXXXXXXXXXXX1
1XXXXXXXXXXXXXXXXXX1
1XXXXXXXXXXXXXXXXXX1
1XXXXXXXXXXXXXXXXXX1
1XXXXXXXXXXXXXXXXXX1
1XXXXXXXXXXXXXXXXXX1
1XXXXXXXXXXXXXXXXXX1
1XXXXXXXXXXXXXXXXXX1
1XXXXXXXXXXXXXXXXXX1
1XXXXXXXXXXXXXXXXXX1
1XXXXXXXXXXXXXXXXXX1
11111111111111111111
