1111111111111111111
1000000000000000001
1000000000000000101
1000000E00000000001
100000000000C000001
1000000000C00000001
1111100000C00000001
1111100000000000001
11P1100000000000001
1111100000000000001
1111111111111111111
