1111111111111111111
1000000000000000001
1000000000000000001
1000000E00010000001
100000001001C000001
1111111P00111110C01
1000000000C00000001
1111100000000000001
1111100000000000001
1111100000000000001
1111111111111111111
