1111111111111111111
1000000000000000001
1000000000000000101
1000000E00000000001
1000000000000000001
1000000000C00000001
1000000000C00000001
1111111000000111111
1000000000C00000001
1000000P00000000001
1111111111111111111
