11111111111111111111
10000000000000000001
10000000000000000001
10000000000000000001
10000000000000000001
10000000000010000001
1000000001001C000001
11111111000111110C01
10000000000C00000001
10000000000C00000001
1E000000000C00000001
10000000000C00000001
10000000000C00000001
11111100000000000001
111111000CPC00000001
11111100000000000001
11111111111111111111
