1111111111111111111
1000000000000000001
1000000000000000101
1000000E00010000001
100000001001C000001
1000P00010C00000001
1111100111C00000001
1111100111000000001
1111100111000000001
1111100111000000001
1111111111111111111
