1111111111111111111
1000000000000000001
1000000000000000101
1000000000000E000E1
100000010000C000001
1000001P10C00000001
10000000C0000000001
1000000000000000001
1000000000000000001
1000000000000000001
1111111111111111111