11111111111111111111
10000000000000000001
10000000000000000001
1000000001000C000001
11111110000111110001
10000000000C00000001
10000000000C00000001
1E000000000C00000001
10000000000C00000001
11111100000C00000001
11111100000001111111
111111000CPC01000001
11111100000001000001
11111111111111111111
