11111111111111111111111111111111
1P010000000000100000000000000001
10000000000001000000000000000001
10000000000000000000000000000001
10000000000000000000000000000001
10000000000000000000000000000001
10000000000000000000000000000001
10C00C00000000000CCCCCCCCCCCCCC1
100001000C000C000000000000000001
1000110100000001E000000000000001
11111111111111111111111111111111
