11111111111111111111
10000000000000000001
10000000000000000001
100000000P0000000001
1000C00000000C000001
100000000E0000000001

