1111111111111111111
1000000000000000001
1000000000000000101
1000000E00000000001
10000P000000C000001
1000000000C00000001
1111100000C00000001
1111100000000000001
1111100000P00000001
1111100000000000001
1111111111111111111
