1111111111111111111111111111
1P01XXXXXXXXXXXXXXCXCXCXCXC1
1001XXX00C00XXXXXX0X0X0X0X01
1001XXX01110XXXXXX0X0X0X0X01
1001XXX01110XXXXXX0X0X0X0X01
100XXXX01110XXXXXX0X0X0X0X01
10000C0011100000000000000001
111111111110000XXXXXXXXXXXX1
100000000C10000XC00000000001
101111111110000XXX0X0X0X0X01
1000000000000000000000000001
1000000000000000000000000001
1000000000000000000000000001
1000000000000000000000000001
100000XX0XX00000000000000001
1C0000XXEXX0000000C0C0C0C0C1
1111111111111111111111111111
