11111111111111111111
1P01XXXXXXXXXXXXXXC1
1001XXX00C00XXXXXX01
1001XXX01110XXXXXX01
1001XXX01110XXXXXX01
100XXXX01110XXXXXX01
10000C00111000000001
111111111110000XXXX1
100000000C10000XC001
101111111110000XXX01
10000000000000000001
10000000000000000001
10000000000000000001
10000000000000000001
100000XX0XX000000001
1C0000XXEXX0000000C1
11111111111111111111
