1111111111111111111
1000000000000000001
1000000000000000101
10000000011111110E1
100000010000C000001
1000001P10C00000001
1111100000C00000001
1111100000000000001
1111100000000000001
1111100000000000001
1111111111111111111
